########
#  $.  #
#  $.  #
#  $. @#
#  $.  #
########