__#####___
__#   ####
__#  $.  #
### # $###
#   # .  #
#@       #
##########