######_
#@ ..#_
# #$ ##
# #   #
#  $# #
#  *  #
#######