#######
#     #
# $ $ #
# $ $@#
# $$ ##
#  ...#
###...#
__#####