#######__
#     #__
# $## ###
# $@$   #
# ### # #
# ...   #
#########