#############
#.   $@$   .#
##. $$ $$ .##
_##. $#$ .##_
__## $ $ ##__
___#.. ..#___
___#######___