_#######__
##  #  ###
# $ # $  #
#  .@.   #
##$ # $###
_# . . #__
_#######__