######__
# .  #__
# .  #__
# * ###_
### @ ##
__#    #
__# $$ #
__###  #
____####