_####___
_#  #___
_# @#___
_#$.#___
##.$####
# $.   #
# .$   #
#  #####
####____