______#####
___####   #
####  $*. #
#  $*.   ##
# @   #####
#  ####____
####_______