__####__
__#  #__
###$ ##_
#  $  #_
#@#*. ##
#  *.  #
###    #
__######