__#####__
_##   ##_
##. $  ##
#  #$#$ #
# #. .  #
#  .@.# #
# $#$#  #
##  $ .##
_##   ##_
__#####__