_______######
_______#@  ##
######## $$ #
#   ...#$   #
#  #... $$  #
#   ...#$ $ #
## #####  $ #
_#     $ # ##
_#######   #_
_______#####_