_##########
_#    #   #
_# $$ #.$.#
_#  # #$  #
_# $  # ###
###$ ##  .#
#.. @    .#
##  #$$# .#
_##.$  # ##
__###.$ .#_
____######_