____######
___## ...#
__## $ # #
__# $ ...#
###$  # ##
# $@#   #_
#  $ #  #_
#   $  ##_
##  #  #__
_#######__