########_______
#   #  #_______
#@$$# $###_____
##       #_____
_#  #    ######
_##  $ # #    #
__#  ##       #
__#####  #.. ##
______##  .. #_
_______###  ##_
_________####__