########
#  Bx  #
#  Bx  #
#  Bx P#
#  Bx  #
########